# Rdebug
# Note: Only ONE true tab-char to separate items!
# Syntax Coloring Map

# KEYWORD1: Datatypes
# KEYWORD2: Classes, Namespaces, Methods, and Functions
# KEYWORD3: Structure
# LITERAL1: Constants

Rdebug	KEYWORD2

debug	KEYWORD2
debugln	KEYWORD2
debugD	KEYWORD2
debuglnD	KEYWORD2
debugI	KEYWORD2
debuglnI	KEYWORD2
debugW	KEYWORD2
debuglnW	KEYWORD2
debugE	KEYWORD2
debuglnE	KEYWORD2

DEBUGLEVEL_OFF	LITERAL1
DEBUGLEVEL_ON	LITERAL1
DEBUGLEVEL_DEBUG	LITERAL1
DEBUGLEVEL_INFO	LITERAL1
DEBUGLEVEL_WARN	LITERAL1
DEBUGLEVEL_ERROR	LITERAL1
